Level 0
######
#@  ##
#.$* #
#  # #
#    #
######