Level 7
 ########
 ##    ##
 # ..   #
 # # $$$#
 #   #@.#
 ########