Level 9
 #######
 #@ ..##
 # #$ ##
 # #   #
 #  $# #
 #  *  #
 #######